Player,School,Conf,G,Rec,Yds,Avg,TD,Att,Yds,Avg,TD,Plays,Yds,Avg,TD
Jalen Robinette,Air Force,MWC,12,35,959,27.4,6,0,0,,0,35,959,27.4,6
Jester Weah,Pitt,ACC,13,36,870,24.2,10,0,0,,0,36,870,24.2,10
Jaylen Smith,Louisville,ACC,12,27,599,22.2,6,0,0,,0,27,599,22.2,6
Shelton Gibson,West Virginia,Big 12,13,43,951,22.1,8,2,29,14.5,0,45,980,21.8,8
Olabisi Johnson,Colorado State,MWC,11,28,613,21.9,4,1,13,13.0,0,29,626,21.6,4
Jeff Badet,Kentucky,SEC,13,31,670,21.6,4,1,25,25.0,0,32,695,21.7,4
Micah Holder,San Diego State,MWC,10,27,581,21.5,5,0,0,,0,27,581,21.5,5
Cedric Wilson,Boise State,MWC,12,56,1129,20.2,11,3,7,2.3,0,59,1136,19.3,11
Cody Thompson,Toledo,MAC,13,64,1269,19.8,11,0,0,,0,64,1269,19.8,11
Dieuly Aristilde,Eastern Michigan,MAC,5,25,492,19.7,2,0,0,,0,25,492,19.7,2
James Washington,Oklahoma State,Big 12,13,71,1380,19.4,10,4,28,7.0,0,75,1408,18.8,10
Josh Malone,Tennessee,SEC,13,50,972,19.4,11,0,0,,0,50,972,19.4,11
Deangelo Yancey,Purdue,Big Ten,12,49,951,19.4,10,0,0,,0,49,951,19.4,10
Stephen Louis,North Carolina State,ACC,12,35,678,19.4,2,1,3,3.0,0,36,681,18.9,2
Jon'Vea Johnson,Toledo,MAC,12,40,773,19.3,10,0,0,,0,40,773,19.3,10
Jalen Williams,Massachusetts,Ind,10,27,520,19.3,6,0,0,,0,27,520,19.3,6
Rokeem Williams,Miami (OH),MAC,10,26,501,19.3,3,0,0,,0,26,501,19.3,3
Blake Mack,Arkansas State,Sun Belt,11,34,652,19.2,3,0,0,,0,34,652,19.2,3
Dede Westbrook,Oklahoma,Big 12,13,80,1524,19.1,17,10,101,10.1,0,90,1625,18.1,17
Ahmmon Richards,Miami (FL),ACC,13,49,934,19.1,3,2,8,4.0,0,51,942,18.5,3
Deon Cain,Clemson,ACC,15,38,724,19.1,9,0,0,,0,38,724,19.1,9
Josh Stewart,UTSA,CUSA,11,36,682,18.9,5,0,0,,0,36,682,18.9,5
RJ Turner,Louisiana-Monroe,Sun Belt,9,23,433,18.8,3,0,0,,0,23,433,18.8,3
Carlos Henderson,Louisiana Tech,CUSA,13,82,1535,18.7,19,14,133,9.5,2,96,1668,17.4,21
Allen Staggers,Southern Mississippi,CUSA,13,63,1165,18.5,7,3,39,13.0,0,66,1204,18.2,7
Chico McClatcher,Washington,Pac-12,12,31,574,18.5,5,18,131,7.3,1,49,705,14.4,6
Kevin Stepherson,Notre Dame,Ind,10,25,462,18.5,5,0,0,,0,25,462,18.5,5
Tanner Gentry,Wyoming,MWC,14,72,1326,18.4,14,6,30,5.0,0,78,1356,17.4,14
Nick Westbrook,Indiana,Big Ten,12,54,995,18.4,6,1,3,3.0,1,55,998,18.1,7
Jimmy Williams,East Carolina,American,12,45,818,18.2,8,0,0,,0,45,818,18.2,8
Johnathon Johnson,Missouri,SEC,12,24,435,18.1,2,4,114,28.5,0,28,549,19.6,2
Taj Williams,Texas Christian,Big 12,12,39,702,18.0,5,0,0,,0,39,702,18.0,5
Shun Brown,Arizona,Pac-12,12,29,521,18.0,3,2,62,31.0,0,31,583,18.8,3
D.J. Chark,LSU,SEC,11,26,466,17.9,3,12,122,10.2,2,38,588,15.5,5
Jordan Frysinger,Idaho,Sun Belt,8,26,465,17.9,3,0,0,,0,26,465,17.9,3
Taywan Taylor,Western Kentucky,CUSA,14,98,1730,17.7,17,6,36,6.0,0,104,1766,17.0,17
Kevin Kutchera,South Alabama,Sun Belt,11,30,532,17.7,1,0,0,,0,30,532,17.7,1
Adonis Jennings,Temple,American,11,27,474,17.6,4,7,81,11.6,0,34,555,16.3,4
Nicholas Norris,Western Kentucky,CUSA,14,76,1318,17.3,14,13,222,17.1,1,89,1540,17.3,15
Donald Gray,Mississippi State,SEC,12,41,709,17.3,5,0,0,,0,41,709,17.3,5
Trey Hartley,San Jose State,MWC,9,33,572,17.3,4,1,18,18.0,0,34,590,17.4,4
Raelon Singleton,Utah,Pac-12,12,27,464,17.2,4,0,0,,0,27,464,17.2,4
James Quick,Louisville,ACC,12,45,769,17.1,6,0,0,,0,45,769,17.1,6
Michael Clark,Marshall,CUSA,11,37,632,17.1,5,0,0,,0,37,632,17.1,5
Jamari Staples,Louisville,ACC,11,36,615,17.1,2,0,0,,0,36,615,17.1,2
Kelvin Harmon,North Carolina State,ACC,10,27,462,17.1,5,0,0,,0,27,462,17.1,5
Ricky Jeune,Georgia Tech,ACC,11,25,427,17.1,1,1,40,40.0,0,26,467,18.0,1
Josh Reynolds,Texas A&M,SEC,13,61,1039,17.0,12,0,0,,0,61,1039,17.0,12
Deon Watson,Idaho,Sun Belt,12,41,695,17.0,3,0,0,,0,41,695,17.0,3
Xavier Brown,Louisiana-Monroe,Sun Belt,11,25,425,17.0,4,0,0,,0,25,425,17.0,4
Keon Hatcher,Arkansas,SEC,12,44,743,16.9,8,4,7,1.8,0,48,750,15.6,8
Dondre Daley,Iowa State,Big 12,11,24,406,16.9,3,0,0,,0,24,406,16.9,3
Jonathan Giles,Texas Tech,Big 12,11,69,1158,16.8,13,0,0,,0,69,1158,16.8,13
Josh Magee,South Alabama,Sun Belt,11,49,822,16.8,5,0,0,,0,49,822,16.8,5
Michael Gallup,Colorado State,MWC,13,76,1272,16.7,14,4,15,3.8,0,80,1287,16.1,14
James Gardner,Miami (OH),MAC,11,45,750,16.7,6,0,0,,0,45,750,16.7,6
Chris Godwin,Penn State,Big Ten,13,59,982,16.6,11,1,13,13.0,0,60,995,16.6,11
Equanimeous St. Brown,Notre Dame,Ind,12,58,961,16.6,9,0,0,,0,58,961,16.6,9
Ventell Bryant,Temple,American,11,54,895,16.6,4,0,0,,0,54,895,16.6,4
Devonte Boyd,UNLV,MWC,9,45,746,16.6,4,0,0,,0,45,746,16.6,4
Jhajuan Seales,Oklahoma State,Big 12,12,37,615,16.6,4,1,3,3.0,0,38,618,16.3,4
Trey Griffey,Arizona,Pac-12,10,23,382,16.6,2,0,0,,0,23,382,16.6,2
Scott Orndoff,Pitt,ACC,12,35,579,16.5,5,0,0,,0,35,579,16.5,5
Travis Fulgham,Old Dominion,CUSA,12,29,478,16.5,8,0,0,,0,29,478,16.5,8
Courtland Sutton,SMU,American,12,76,1246,16.4,10,0,0,,0,76,1246,16.4,10
Jerome Lane,Akron,MAC,12,62,1018,16.4,6,0,0,,0,62,1018,16.4,6
Sebastian Smith,Ohio,MAC,13,55,900,16.4,4,1,5,5.0,0,56,905,16.2,4
Papi White,Ohio,MAC,12,41,672,16.4,6,47,206,4.4,3,88,878,10.0,9
Temi Alaka,Rice,CUSA,9,28,458,16.4,2,0,0,,0,28,458,16.4,2
Auden Tate,Florida State,ACC,10,25,409,16.4,6,0,0,,0,25,409,16.4,6
J'Mon Moore,Missouri,SEC,12,62,1012,16.3,8,0,0,,1,62,1012,16.3,9
Nyqwan Murray,Florida State,ACC,9,27,441,16.3,5,0,0,,0,27,441,16.3,5
DeAndre Thompkins,Penn State,Big Ten,10,27,440,16.3,1,0,0,,0,27,440,16.3,1
Keke Coutee,Texas Tech,Big 12,12,55,890,16.2,7,3,2,0.7,1,58,892,15.4,8
David Njoku,Miami (FL),ACC,12,43,698,16.2,8,0,0,,0,43,698,16.2,8
Byron Pringle,Kansas State,Big 12,13,39,631,16.2,4,3,12,4.0,0,42,643,15.3,4
Chris Platt,Baylor,Big 12,12,35,567,16.2,4,1,8,8.0,0,36,575,16.0,4
Elijah King,Texas State,Sun Belt,9,28,453,16.2,2,0,0,,0,28,453,16.2,2
Phil Mayhue,Memphis,American,12,42,677,16.1,4,0,0,,0,42,677,16.1,4
Jacob Hollister,Wyoming,MWC,12,32,515,16.1,7,1,2,2.0,0,33,517,15.7,7
Jared Cornelius,Arkansas,SEC,11,32,515,16.1,4,13,53,4.1,1,45,568,12.6,5
Ardarius Stewart,Alabama,SEC,12,54,864,16.0,8,8,68,8.5,0,62,932,15.0,8
Ricky Jones,Indiana,Big Ten,13,53,848,16.0,3,1,5,5.0,0,54,853,15.8,3
Jordan Leggett,Clemson,ACC,13,46,736,16.0,7,0,0,,0,46,736,16.0,7
Nate Iese,UCLA,Pac-12,8,25,400,16.0,4,0,0,,0,25,400,16.0,4
Thomas Sperbeck,Boise State,MWC,13,80,1272,15.9,9,11,53,4.8,0,91,1325,14.6,9
Shaedon Meadors,Appalachian State,Sun Belt,12,45,716,15.9,2,0,0,,0,45,716,15.9,2
Kerry Thomas,UTSA,CUSA,11,35,555,15.9,8,1,2,2.0,0,36,557,15.5,8
Amba Etta-Tawo,Syracuse,ACC,12,94,1482,15.8,14,0,0,,0,94,1482,15.8,14
Shay Fields,Colorado,Pac-12,14,56,883,15.8,9,1,12,12.0,0,57,895,15.7,9
Jamire Jordan,Fresno State,MWC,12,45,713,15.8,2,17,83,4.9,1,62,796,12.8,3
Tim Patrick,Utah,Pac-12,10,45,711,15.8,5,0,0,,0,45,711,15.8,5
Jamir Tillman,Navy,American,13,40,631,15.8,2,2,14,7.0,0,42,645,15.4,2
Chris Lacy,Oklahoma State,Big 12,12,31,489,15.8,3,0,0,,0,31,489,15.8,3
Mark Andrews,Oklahoma,Big 12,12,31,489,15.8,7,0,0,,0,31,489,15.8,7
Jake Maulhardt,Wyoming,MWC,13,39,614,15.7,4,0,0,,0,39,614,15.7,4
Justin Holmes,San Jose State,MWC,12,39,613,15.7,3,0,0,,0,39,613,15.7,3
Tony Stevens,Auburn,SEC,9,31,487,15.7,3,0,0,,0,31,487,15.7,3
Cameron Echols-Luper,Arkansas State,Sun Belt,13,26,407,15.7,1,7,8,1.1,0,33,415,12.6,1
Bug Howard,North Carolina,ACC,12,53,827,15.6,8,0,0,,0,53,827,15.6,8
Damore'ea Stringfellow,Ole Miss,SEC,12,46,716,15.6,6,0,0,,0,46,716,15.6,6
Richie James,Middle Tennessee State,CUSA,13,105,1625,15.5,12,38,339,8.9,4,143,1964,13.7,16
Corey Davis,Western Michigan,MAC,14,97,1500,15.5,19,1,0,0.0,0,98,1500,15.3,19
Dante Pettis,Washington,Pac-12,13,53,822,15.5,15,0,0,,0,53,822,15.5,15
D.J. Moore,Maryland,Big Ten,13,41,637,15.5,6,11,55,5.0,0,52,692,13.3,6
Keith Kirkwood,Temple,American,14,42,648,15.4,4,2,20,10.0,0,44,668,15.2,4
Tyree McCants,South Florida,American,11,25,384,15.4,4,2,12,6.0,0,27,396,14.7,4
Demetris Robertson,California,Pac-12,12,50,767,15.3,7,0,0,,0,50,767,15.3,7
Jonathan Duhart,Old Dominion,CUSA,13,48,735,15.3,9,0,0,,0,48,735,15.3,9
Austin Wolf,Akron,MAC,12,36,550,15.3,5,0,0,,0,36,550,15.3,5
Corey Willis,Central Michigan,MAC,13,72,1091,15.2,9,2,4,2.0,0,74,1095,14.8,9
Carrington Thompson,Western Michigan,MAC,13,42,637,15.2,6,0,0,,0,42,637,15.2,6
Anthony Miller,Memphis,American,13,95,1434,15.1,14,12,69,5.8,1,107,1503,14.0,15
Marcus Kemp,Hawaii,MWC,14,73,1100,15.1,8,0,0,,0,73,1100,15.1,8
Amara Darboh,Michigan,Big Ten,13,57,862,15.1,7,0,0,,0,57,862,15.1,7
Jordan Lasley,UCLA,Pac-12,11,41,620,15.1,5,0,0,,0,41,620,15.1,5
Ian Sadler,Texas Tech,Big 12,8,24,363,15.1,0,0,0,,0,24,363,15.1,0
Tre'Quan Smith,UCF,American,12,57,853,15.0,5,0,0,,0,57,853,15.0,5
Travis Rudolph,Florida State,ACC,13,56,840,15.0,7,0,0,,0,56,840,15.0,7
Garrett Johnson,Kentucky,SEC,13,39,585,15.0,5,0,0,,0,39,585,15.0,5
R.J. Shelton,Michigan State,Big Ten,12,53,789,14.9,5,18,121,6.7,0,71,910,12.8,5
DaeSean Hamilton,Penn State,Big Ten,12,34,506,14.9,1,1,-12,-12.0,0,35,494,14.1,1
Allen Lazard,Iowa State,Big 12,12,69,1018,14.8,7,0,0,,0,69,1018,14.8,7
Devin Gray,Cincinnati,American,12,58,860,14.8,5,3,-2,-0.7,0,61,858,14.1,5
Malik Turner,Illinois,Big Ten,11,48,712,14.8,6,2,5,2.5,0,50,717,14.3,6
Jazz Peavy,Wisconsin,Big Ten,14,43,635,14.8,5,21,318,15.1,1,64,953,14.9,6
Dalvin Cook,Florida State,ACC,13,33,488,14.8,1,288,1765,6.1,19,321,2253,7.0,20
Keevan Lucas,Tulsa,American,13,81,1180,14.6,15,8,45,5.6,0,89,1225,13.8,15
Zach Pascal,Old Dominion,CUSA,13,65,946,14.6,9,23,145,6.3,0,88,1091,12.4,9
Chance Allen,Houston,American,12,56,815,14.6,6,0,0,,0,56,815,14.6,6
Gerald Everett,South Alabama,Sun Belt,12,49,717,14.6,4,0,0,,0,49,717,14.6,4
Kendall Sanders,Arkansas State,Sun Belt,12,38,553,14.6,7,0,0,,0,38,553,14.6,7
Jeff Smith,Boston College,ACC,12,27,395,14.6,3,35,199,5.7,1,62,594,9.6,4
Sergio Bailey,Eastern Michigan,MAC,13,60,868,14.5,7,3,22,7.3,0,63,890,14.1,7
Malachi Dupre,LSU,SEC,11,41,593,14.5,3,0,0,,0,41,593,14.5,3
Jauan Jennings,Tennessee,SEC,13,40,580,14.5,7,5,27,5.4,0,45,607,13.5,7
Joe Mixon,Oklahoma,Big 12,12,37,538,14.5,5,187,1274,6.8,10,224,1812,8.1,15
Deshaunte Jones,Iowa State,Big 12,12,37,536,14.5,6,4,31,7.8,0,41,567,13.8,6
Bra'Lon Cherry,North Carolina State,ACC,13,30,434,14.5,3,0,0,,0,30,434,14.5,3
John Mundt,Oregon,Pac-12,8,23,334,14.5,4,0,0,,0,23,334,14.5,4
Robert Davis,Georgia State,Sun Belt,12,67,968,14.4,5,0,0,,0,67,968,14.4,5
Bucky Hodges,Virginia Tech,ACC,14,48,691,14.4,7,9,42,4.7,0,57,733,12.9,7
Isaiah McKenzie,Georgia,SEC,13,44,633,14.4,7,19,134,7.1,2,63,767,12.2,9
Cole Freytag,UTEP,CUSA,12,36,520,14.4,5,1,4,4.0,0,37,524,14.2,5
Saquon Barkley,Penn State,Big Ten,14,28,402,14.4,4,272,1496,5.5,18,300,1898,6.3,22
B.J. Johnson,Georgia Southern,Sun Belt,11,42,600,14.3,3,0,0,,0,42,600,14.3,3
Marcus McGill,Buffalo,MAC,11,40,573,14.3,0,0,0,,0,40,573,14.3,0
Jehu Chesson,Michigan,Big Ten,13,35,500,14.3,2,12,63,5.3,1,47,563,12.0,3
John Ross,Washington,Pac-12,14,81,1150,14.2,17,8,102,12.8,1,89,1252,14.1,18
Evan Engram,Ole Miss,SEC,11,65,926,14.2,8,0,0,,0,65,926,14.2,8
Daikiel Shorts,West Virginia,Big 12,13,63,894,14.2,5,0,0,,0,63,894,14.2,5
Bruce Natson,Akron,MAC,12,59,837,14.2,10,4,6,1.5,0,63,843,13.4,10
Cam Serigne,Wake Forest,ACC,12,30,426,14.2,3,0,0,,0,30,426,14.2,3
A.J. Brown,Ole Miss,SEC,11,29,412,14.2,2,0,0,,0,29,412,14.2,2
Mike Gesicki,Penn State,Big Ten,14,48,679,14.1,5,0,0,,0,48,679,14.1,5
Darren Carrington,Oregon,Pac-12,12,43,606,14.1,5,1,6,6.0,0,44,612,13.9,5
Montay Crockett,Georgia Southern,Sun Belt,11,24,339,14.1,1,2,25,12.5,0,26,364,14.0,1
Justin Hunt,Marshall,CUSA,10,23,324,14.1,5,0,0,,0,23,324,14.1,5
K.D. Cannon,Baylor,Big 12,12,87,1215,14.0,13,0,0,,0,87,1215,14.0,13
Nacarius Fant,Western Kentucky,CUSA,9,29,407,14.0,2,6,26,4.3,0,35,433,12.4,2
Mike Williams,Clemson,ACC,15,98,1361,13.9,11,0,0,,0,98,1361,13.9,11
Austin Carr,Northwestern,Big Ten,13,90,1247,13.9,12,0,0,,0,90,1247,13.9,12
Thomas Owens,Florida International,CUSA,12,47,652,13.9,7,1,1,1.0,0,48,653,13.6,7
Austin Proehl,North Carolina,ACC,13,43,597,13.9,3,0,0,,0,43,597,13.9,3
Terren Encalade,Tulane,American,12,36,500,13.9,6,5,41,8.2,0,41,541,13.2,6
Stantley Thomas,Florida International,CUSA,11,35,485,13.9,1,0,0,,0,35,485,13.9,1
Trent Sherfield,Vanderbilt,SEC,12,34,472,13.9,1,7,97,13.9,1,41,569,13.9,2
Andre Patton,Rutgers,Big Ten,10,33,460,13.9,5,0,0,,0,33,460,13.9,5
Deante Burton,Kansas State,Big 12,10,29,404,13.9,1,0,0,,0,29,404,13.9,1
Isaiah Ford,Virginia Tech,ACC,13,79,1094,13.8,7,6,33,5.5,0,85,1127,13.3,7
Jordan Westerkamp,Nebraska,Big Ten,10,38,526,13.8,5,3,18,6.0,1,41,544,13.3,6
Andrew Celis,Nevada,MWC,11,23,318,13.8,0,2,9,4.5,0,25,327,13.1,0
Kalib Woods,Florida Atlantic,CUSA,12,68,934,13.7,1,0,0,,0,68,934,13.7,1
Justin Hobbs,Tulsa,American,13,50,685,13.7,4,0,0,,0,50,685,13.7,4
Aaron Peck,Fresno State,MWC,11,46,630,13.7,3,0,0,,0,46,630,13.7,3
Glenn Smith,Georgia State,Sun Belt,12,40,547,13.7,3,41,150,3.7,2,81,697,8.6,5
Torii Hunter Jr,Notre Dame,Ind,8,38,521,13.7,3,0,0,,0,38,521,13.7,3
Donnie Corley,Michigan State,Big Ten,11,33,453,13.7,3,8,44,5.5,0,41,497,12.1,3
Stanley Morgan Jr.,Nebraska,Big Ten,13,33,453,13.7,2,1,0,0.0,0,34,453,13.3,2
Anthony Nash,Duke,ACC,6,29,398,13.7,2,0,0,,0,29,398,13.7,2
Dorian Leonard,Texas,Big 12,10,29,397,13.7,3,0,-12,,0,29,385,13.3,3
Chad Hansen,California,Pac-12,10,92,1249,13.6,11,0,0,,0,92,1249,13.6,11
Joshua Atkinson,Tulsa,American,13,78,1058,13.6,8,0,0,,0,78,1058,13.6,8
Austin Duke,Charlotte,CUSA,12,59,803,13.6,4,11,40,3.6,0,70,843,12.0,4
Teo Redding,Bowling Green State,MAC,12,31,423,13.6,3,0,0,,0,31,423,13.6,3
Tommy Sweeney,Boston College,ACC,11,26,353,13.6,3,0,0,,0,26,353,13.6,3
Mark Chapman,Central Michigan,MAC,12,44,592,13.5,4,6,71,11.8,0,50,663,13.3,4
Keenan Barnes,Louisiana,Sun Belt,12,31,418,13.5,6,0,0,,0,31,418,13.5,6
Antonio Callaway,Florida,SEC,12,54,721,13.4,3,5,32,6.4,1,59,753,12.8,4
Cole Hikutini,Louisville,ACC,13,50,668,13.4,8,0,0,,0,50,668,13.4,8
Bryan Edwards,South Carolina,SEC,12,44,590,13.4,4,0,0,,0,44,590,13.4,4
Christian Blake,Northern Illinois,MAC,12,34,457,13.4,2,10,31,3.1,1,44,488,11.1,3
John Diarse,Texas Christian,Big 12,13,33,442,13.4,3,0,0,,0,33,442,13.4,3
Dennis Andrews,Middle Tennessee State,CUSA,12,32,428,13.4,8,11,60,5.5,3,43,488,11.3,11
Trent Taylor,Louisiana Tech,CUSA,14,136,1803,13.3,12,0,0,,0,136,1803,13.3,12
Kenny Golladay,Northern Illinois,MAC,12,87,1156,13.3,8,20,192,9.6,2,107,1348,12.6,10
Deebo Samuel,South Carolina,SEC,10,59,783,13.3,1,15,98,6.5,6,74,881,11.9,7
Tyler Conklin,Central Michigan,MAC,12,42,560,13.3,6,0,0,,0,42,560,13.3,6
River Cracraft,Washington State,Pac-12,10,53,701,13.2,5,0,0,,0,53,701,13.2,5
O.J. Howard,Alabama,SEC,15,45,595,13.2,3,0,0,,0,45,595,13.2,3
Robert Wheelwright,Wisconsin,Big Ten,12,34,448,13.2,1,1,6,6.0,0,35,454,13.0,1
Kyle Sweet,Washington State,Pac-12,13,27,357,13.2,3,1,5,5.0,0,28,362,12.9,3
Scott Miller,Bowling Green State,MAC,12,74,968,13.1,10,0,0,,0,74,968,13.1,10
JuJu Smith-Schuster,USC,Pac-12,13,70,914,13.1,10,5,27,5.4,0,75,941,12.5,10
Steven Dunbar,Houston,American,13,53,692,13.1,5,0,0,,0,53,692,13.1,5
Ron'Quavion Tarver,Utah State,MWC,12,46,602,13.1,3,0,0,,0,46,602,13.1,3
Drew Wolitarsky,Minnesota,Big Ten,13,66,860,13.0,5,3,6,2.0,0,69,866,12.6,5
Quincy Adeboyejo,Ole Miss,SEC,12,35,456,13.0,1,0,0,,0,35,456,13.0,1
Tevaris McCormick,Troy,Sun Belt,10,35,456,13.0,5,2,2,1.0,0,37,458,12.4,5
Cortez Lewis,Wake Forest,ACC,11,32,415,13.0,1,0,0,,0,32,415,13.0,1
Jesus Wilson,Florida State,ACC,7,30,390,13.0,1,1,6,6.0,0,31,396,12.8,1
Dontre Wilson,Ohio State,Big Ten,11,27,352,13.0,5,16,78,4.9,1,43,430,10.0,6
Izaiah Lottie,New Mexico State,Sun Belt,10,26,339,13.0,2,0,0,,0,26,339,13.0,2
Cam Phillips,Virginia Tech,ACC,14,76,983,12.9,5,30,140,4.7,0,106,1123,10.6,5
Andy Isabella,Massachusetts,Ind,12,62,801,12.9,7,12,100,8.3,0,74,901,12.2,7
Darren Andrews,UCLA,Pac-12,11,55,709,12.9,4,2,27,13.5,1,57,736,12.9,5
Wyatt Demps,Nevada,MWC,12,53,686,12.9,9,0,0,,0,53,686,12.9,9
Nigel Kilby,Eastern Michigan,MAC,9,34,437,12.9,4,0,0,,0,34,437,12.9,4
Pharaoh Brown,Oregon,Pac-12,9,33,426,12.9,5,0,0,,0,33,426,12.9,5
Jay MacIntyre,Colorado,Pac-12,13,32,412,12.9,1,4,12,3.0,0,36,424,11.8,1
Chaz Anderson,Boise State,MWC,11,30,386,12.9,0,2,-7,-3.5,0,32,379,11.8,0
Monty Madaris,Michigan State,Big Ten,10,24,310,12.9,1,1,12,12.0,0,25,322,12.9,1
Hergy Mayala,Connecticut,American,9,23,296,12.9,0,0,0,,0,23,296,12.9,0
Ishmael Zamora,Baylor,Big 12,10,63,809,12.8,8,5,27,5.4,0,68,836,12.3,8
Hayden Hurst,South Carolina,SEC,13,48,616,12.8,1,2,9,4.5,0,50,625,12.5,1
Jared Murphy,Miami (OH),MAC,13,43,552,12.8,5,2,-1,-0.5,0,45,551,12.2,5
Jeremy McNichols,Boise State,MWC,13,37,474,12.8,4,314,1709,5.4,23,351,2183,6.2,27
Cory Butler,Utah,Pac-12,8,29,372,12.8,0,20,163,8.2,1,49,535,10.9,1
John Niupalau,Eastern Michigan,MAC,11,28,359,12.8,4,0,0,,0,28,359,12.8,4
Frederick Gammage,Arizona State,Pac-12,8,26,334,12.8,2,1,0,0.0,0,27,334,12.4,2
Ricky Seals-Jones,Texas A&M,SEC,9,26,333,12.8,1,0,0,,0,26,333,12.8,1
Fred Ross,Mississippi State,SEC,13,72,917,12.7,12,2,39,19.5,0,74,956,12.9,12
Tim White,Arizona State,Pac-12,12,56,713,12.7,2,5,-4,-0.8,0,61,709,11.6,2
Thaddeous Thompson,North Texas,CUSA,12,43,545,12.7,2,0,0,,0,43,545,12.7,2
Michael Walker,Boston College,ACC,13,33,420,12.7,4,8,41,5.1,0,41,461,11.2,4
Jahad Thomas,Temple,American,12,33,418,12.7,6,207,953,4.6,13,240,1371,5.7,19
Kahlil Lewis,Cincinnati,American,11,48,605,12.6,5,9,107,11.9,0,57,712,12.5,5
Noah Brown,Ohio State,Big Ten,12,32,402,12.6,7,0,0,,0,32,402,12.6,7
Justin Hardee,Illinois,Big Ten,10,25,314,12.6,0,1,12,12.0,0,26,326,12.5,0
Doni Dowling,Virginia,ACC,11,50,626,12.5,4,0,0,,0,50,626,12.5,4
Dimetrios Mason,Missouri,SEC,11,47,587,12.5,3,2,29,14.5,0,49,616,12.6,3
Bryce Bobo,Colorado,Pac-12,12,44,548,12.5,2,0,0,,0,44,548,12.5,2
Nate Phillips,Arizona,Pac-12,11,33,414,12.5,2,0,0,,0,33,414,12.5,2
Daniel Montiel,Memphis,American,11,27,338,12.5,3,0,0,,0,27,338,12.5,3
Corey Jones,Toledo,MAC,13,66,817,12.4,5,2,6,3.0,0,68,823,12.1,5
Michael Henry,Western Michigan,MAC,14,63,779,12.4,4,0,0,,0,63,779,12.4,4
James Proche,SMU,American,12,57,709,12.4,6,4,15,3.8,0,61,724,11.9,6
Darreus Rogers,USC,Pac-12,13,56,696,12.4,4,0,0,,0,56,696,12.4,4
Armanti Foreman,Texas,Big 12,10,34,420,12.4,3,0,0,,0,34,420,12.4,3
Myles Campbell,Georgia Southern,Sun Belt,10,31,384,12.4,4,2,8,4.0,0,33,392,11.9,4
Isaac Nauta,Georgia,SEC,11,29,361,12.4,3,0,0,,0,29,361,12.4,3
Brady Jones,UTSA,CUSA,11,26,322,12.4,3,1,-1,-1.0,0,27,321,11.9,3
Bernard Davis,Massachusetts,Ind,10,24,298,12.4,2,0,0,,0,24,298,12.4,2
Rodney Adams,South Florida,American,13,67,822,12.3,5,23,231,10.0,5,90,1053,11.7,10
Deondre Douglas,Troy,Sun Belt,13,60,740,12.3,6,1,1,1.0,0,61,741,12.1,6
John Ursua,Hawaii,MWC,14,53,652,12.3,3,4,8,2.0,1,57,660,11.6,4
Troy Fumagalli,Wisconsin,Big Ten,13,47,580,12.3,2,0,0,,0,47,580,12.3,2
Riley McCarron,Iowa,Big Ten,12,42,517,12.3,4,2,-3,-1.5,0,44,514,11.7,4
Jawuan Harris,Rutgers,Big Ten,11,39,481,12.3,3,7,-6,-0.9,0,46,475,10.3,3
Jaleel Scott,New Mexico State,Sun Belt,11,23,283,12.3,5,0,0,,0,23,283,12.3,5
Al-Damion Riles,Louisiana,Sun Belt,13,60,729,12.2,2,10,46,4.6,0,70,775,11.1,2
Nyheim Hines,North Carolina State,ACC,12,43,525,12.2,0,13,44,3.4,0,56,569,10.2,0
Ronnie Moore,Bowling Green State,MAC,12,42,513,12.2,1,8,21,2.6,2,50,534,10.7,3
Workpeh Kofa,Charlotte,CUSA,12,27,329,12.2,5,0,0,,0,27,329,12.2,5
Jordan Veasy,California,Pac-12,10,25,306,12.2,3,0,0,,0,25,306,12.2,3
C.J Sanders,Notre Dame,Ind,12,24,293,12.2,2,4,22,5.5,0,28,315,11.3,2
Ka'Raun White,West Virginia,Big 12,11,48,583,12.1,5,0,0,,0,48,583,12.1,5
Geno Lewis,Oklahoma,Big 12,12,32,388,12.1,2,0,0,,0,32,388,12.1,2
Stacy Coley,Miami (FL),ACC,13,63,754,12.0,9,0,0,,0,63,754,12.0,9
Jonnu Smith,Florida International,CUSA,11,42,506,12.0,4,1,5,5.0,0,43,511,11.9,4
Hayden Plinke,UTEP,CUSA,12,38,456,12.0,8,0,0,,0,38,456,12.0,8
Jacorey Warrick,Texas,Big 12,11,30,360,12.0,3,0,0,,0,30,360,12.0,3
Justin Rankin,Kent State,MAC,11,28,335,12.0,1,108,511,4.7,3,136,846,6.2,4
Steven Sims Jr.,Kansas,Big 12,12,72,859,11.9,7,2,-9,-4.5,0,74,850,11.5,7
Jake Butt,Michigan,Big Ten,12,46,546,11.9,4,0,0,,0,46,546,11.9,4
Bilal Marshall,Purdue,Big Ten,12,40,477,11.9,3,9,14,1.6,0,49,491,10.0,3
Trenton Irwin,Stanford,Pac-12,13,37,442,11.9,1,0,0,,0,37,442,11.9,1
T.L. Ford,Charlotte,CUSA,12,36,430,11.9,4,0,0,,0,36,430,11.9,4
Blake Lynch,Baylor,Big 12,11,34,404,11.9,3,12,80,6.7,0,46,484,10.5,3
Robert Lewis,Washington State,Pac-12,12,33,394,11.9,3,1,1,1.0,0,34,395,11.6,3
Christopher Herndon IV,Miami (FL),ACC,13,28,334,11.9,2,0,0,,0,28,334,11.9,2
Tyrone Williams,South Alabama,Sun Belt,11,28,333,11.9,1,0,0,,0,28,333,11.9,1
Patrick Smith,Middle Tennessee State,CUSA,11,28,332,11.9,4,0,0,,0,28,332,11.9,4
Noel Thomas,Connecticut,American,12,100,1179,11.8,3,13,60,4.6,0,113,1239,11.0,3
Laquvionte Gonzalez,Kansas,Big 12,12,62,729,11.8,3,3,-9,-3.0,0,65,720,11.1,3
Tim Crawley,San Jose State,MWC,12,55,648,11.8,3,17,91,5.4,2,72,739,10.3,5
Victor Bolden,Oregon State,Pac-12,12,46,542,11.8,2,28,329,11.8,2,74,871,11.8,4
Michael Roberts,Toledo,MAC,13,45,533,11.8,16,0,0,,0,45,533,11.8,16
Tabari Hines,Wake Forest,ACC,12,38,447,11.8,3,3,-4,-1.3,0,41,443,10.8,3
Korey Robertson,Southern Mississippi,CUSA,13,37,437,11.8,3,1,-3,-3.0,0,38,434,11.4,3
Turner Smiley,North Texas,CUSA,10,33,389,11.8,2,0,0,,0,33,389,11.8,2
Gregory Hogan,New Mexico State,Sun Belt,9,32,377,11.8,3,0,0,,0,32,377,11.8,3
Kalija Lipscomb,Vanderbilt,SEC,11,27,319,11.8,2,3,5,1.7,0,30,324,10.8,2
Sean Culkin,Missouri,SEC,9,24,282,11.8,0,0,0,,0,24,282,11.8,0
Curtis Samuel,Ohio State,Big Ten,13,74,865,11.7,7,97,771,7.9,8,171,1636,9.6,15
KeeSean Johnson,Fresno State,MWC,12,66,773,11.7,6,3,13,4.3,0,69,786,11.4,6
Rayshad Lewis,Utah State,MWC,12,40,469,11.7,2,10,110,11.0,1,50,579,11.6,3
Domonique Young,Purdue,Big Ten,5,29,338,11.7,1,0,0,,0,29,338,11.7,1
Eddie Sinegal,UTEP,CUSA,9,29,338,11.7,0,2,44,22.0,0,31,382,12.3,0
Ryan Switzer,North Carolina,ACC,13,96,1112,11.6,6,3,14,4.7,0,99,1126,11.4,6
Dylan Cantrell,Texas Tech,Big 12,10,58,675,11.6,8,0,0,,0,58,675,11.6,8
Steve Ishmael,Syracuse,ACC,10,48,559,11.6,1,0,0,,0,48,559,11.6,1
Teldrick Morgan,Maryland,Big Ten,13,43,497,11.6,4,6,34,5.7,0,49,531,10.8,4
Seth Collins,Oregon State,Pac-12,10,36,418,11.6,1,15,30,2.0,0,51,448,8.8,1
Kermit Whitfield,Florida State,ACC,13,34,395,11.6,1,8,79,9.9,1,42,474,11.3,2
Callen Hightower,Idaho,Sun Belt,10,33,383,11.6,3,4,7,1.8,0,37,390,10.5,3
Jaquil Capel,Appalachian State,Sun Belt,12,25,290,11.6,1,0,0,,0,25,290,11.6,1
Adam Breneman,Massachusetts,Ind,12,70,808,11.5,8,0,0,,0,70,808,11.5,8
Olamide Zaccheaus,Virginia,ACC,12,51,584,11.5,7,3,24,8.0,0,54,608,11.3,7
Kylen Granson,Rice,CUSA,7,33,381,11.5,2,4,41,10.3,0,37,422,11.4,2
Jeremy Sprinkle,Arkansas,SEC,12,33,380,11.5,4,0,0,,0,33,380,11.5,4
Michael Rector,Stanford,Pac-12,12,32,367,11.5,3,5,71,14.2,1,37,438,11.8,4
Ryan Smith,Miami (OH),MAC,11,31,356,11.5,5,0,0,,0,31,356,11.5,5
Jonah Trinnaman,Brigham Young,Ind,10,28,321,11.5,1,0,0,,0,28,321,11.5,1
Linell Bonner,Houston,American,12,98,1118,11.4,3,5,6,1.2,0,103,1124,10.9,3
Kevonn Mabon,Ball State,MAC,12,85,972,11.4,3,12,64,5.3,1,97,1036,10.7,4
Devin Ross,Colorado,Pac-12,14,69,787,11.4,5,3,10,3.3,0,72,797,11.1,5
Drew Morgan,Arkansas,SEC,13,65,739,11.4,3,4,8,2.0,0,69,747,10.8,3
Tavares Martin Jr,Washington State,Pac-12,13,64,728,11.4,7,0,0,,0,64,728,11.4,7
N'Keal Harry,Arizona State,Pac-12,12,58,659,11.4,5,3,69,23.0,2,61,728,11.9,7
Trent Cowan,Idaho,Sun Belt,13,48,547,11.4,6,0,0,,0,48,547,11.4,6
Thurman Morbley,Texas State,Sun Belt,10,35,400,11.4,2,5,36,7.2,0,40,436,10.9,2
Andrew Scanlan,Northwestern,Big Ten,13,29,331,11.4,0,0,0,,0,29,331,11.4,0
Gabe Schrade,Texas State,Sun Belt,8,25,286,11.4,2,0,0,,0,25,286,11.4,2
Jordan Reid,Ohio,MAC,14,58,655,11.3,6,0,0,,0,58,655,11.3,6
Hunter Renfrow,Clemson,ACC,11,44,495,11.3,6,0,0,,0,44,495,11.3,6
Deon-Tay McManus,Marshall,CUSA,10,40,453,11.3,3,0,0,,0,40,453,11.3,3
Keith Rucker,Georgia State,Sun Belt,10,32,362,11.3,2,0,0,,0,32,362,11.3,2
Collin Johnson,Texas,Big 12,9,28,315,11.3,3,0,0,,0,28,315,11.3,3
Christian Kirk,Texas A&M,SEC,13,83,928,11.2,9,8,35,4.4,0,91,963,10.6,9
C.J. Duncan,Vanderbilt,SEC,12,44,494,11.2,0,0,0,,0,44,494,11.2,0
Antoine Porter,Eastern Michigan,MAC,11,44,491,11.2,4,1,0,0.0,0,45,491,10.9,4
Flynn Nagel,Northwestern,Big Ten,11,40,447,11.2,2,0,0,,0,40,447,11.2,2
Henry Bussey,Florida Atlantic,CUSA,10,24,269,11.2,2,3,17,5.7,0,27,286,10.6,2
Zay Jones,East Carolina,American,12,158,1746,11.1,8,4,24,6.0,0,162,1770,10.9,8
Jalen McCleskey,Oklahoma State,Big 12,13,73,812,11.1,7,3,9,3.0,0,76,821,10.8,7
Ty Lee,Middle Tennessee State,CUSA,13,63,699,11.1,9,6,107,17.8,1,69,806,11.7,10
Mitchell Paige,Indiana,Big Ten,13,58,646,11.1,4,5,36,7.2,1,63,682,10.8,5
Deontay Burnett,USC,Pac-12,12,56,622,11.1,7,3,31,10.3,0,59,653,11.1,7
Van Jefferson,Ole Miss,SEC,12,49,543,11.1,3,5,40,8.0,0,54,583,10.8,3
Darnell Mooney,Tulane,American,9,24,267,11.1,2,4,22,5.5,0,28,289,10.3,2
Jerrod Heard,Texas,Big 12,9,24,266,11.1,3,1,-12,-12.0,0,25,254,10.2,3
Mason Schreck,Buffalo,MAC,12,59,651,11.0,4,0,0,,0,59,651,11.0,4
Nick Kurtz,Brigham Young,Ind,12,49,541,11.0,2,0,0,,0,49,541,11.0,2
Andrew Rodriguez,Utah State,MWC,12,26,286,11.0,1,0,0,,0,26,286,11.0,1
Quadree Henderson,Pitt,ACC,13,26,286,11.0,1,60,631,10.5,5,86,917,10.7,6
D.J. Thompson,Southern Mississippi,CUSA,10,47,510,10.9,6,1,0,0.0,0,48,510,10.6,6
Chris Taylor,Duke,ACC,10,29,315,10.9,1,0,0,,0,29,315,10.9,1
Arkeel Newsome,Connecticut,American,12,25,273,10.9,2,147,715,4.9,5,172,988,5.7,7
Brisly Estime,Syracuse,ACC,12,48,518,10.8,3,4,22,5.5,0,52,540,10.4,3
Jake Oliver,Texas,Big 12,12,33,358,10.8,0,0,0,,0,33,358,10.8,0
Anthony Wales,Western Kentucky,CUSA,13,30,323,10.8,2,237,1621,6.8,27,267,1944,7.3,29
Jacob Sannon,Idaho,Sun Belt,10,28,303,10.8,2,0,0,,0,28,303,10.8,2
Calvin Ridley,Alabama,SEC,15,72,769,10.7,7,5,21,4.2,1,77,790,10.3,8
Cameron Batson,Texas Tech,Big 12,12,60,644,10.7,8,2,4,2.0,0,62,648,10.5,8
Charles Nelson,Oregon,Pac-12,12,52,554,10.7,5,4,37,9.3,1,56,591,10.6,6
Kalen Ballage,Arizona State,Pac-12,12,44,469,10.7,1,126,536,4.3,14,170,1005,5.9,15
Ito Smith,Southern Mississippi,CUSA,13,43,459,10.7,2,265,1459,5.5,17,308,1918,6.2,19
Levern Jacobs,Maryland,Big Ten,13,41,439,10.7,2,1,10,10.0,0,42,449,10.7,2
Todd Boyd,Georgia State,Sun Belt,9,33,352,10.7,1,2,7,3.5,0,35,359,10.3,1
T.J. Rahming,Duke,ACC,11,70,742,10.6,1,1,-1,-1.0,0,71,741,10.4,1
Xavier Castille,SMU,American,11,40,423,10.6,1,0,0,,0,40,423,10.6,1
Ryan Yurachek,Marshall,CUSA,11,28,298,10.6,5,1,9,9.0,0,29,307,10.6,5
Shane Wimann,Northern Illinois,MAC,12,24,254,10.6,6,0,0,,0,24,254,10.6,6
Trever Ryen,Iowa State,Big 12,11,37,388,10.5,2,1,8,8.0,0,38,396,10.4,2
Taylor Oldham,UCF,American,11,35,366,10.5,1,0,0,,0,35,366,10.5,1
D'Ernest Johnson,South Florida,American,13,28,293,10.5,5,111,543,4.9,8,139,836,6.0,13
Vic Wharton,California,Pac-12,10,28,293,10.5,1,0,0,,0,28,293,10.5,1
Aregeros Turner,Northern Illinois,MAC,12,40,415,10.4,3,25,167,6.7,2,65,582,9.0,5
Terry Godwin,Georgia,SEC,13,38,397,10.4,0,4,14,3.5,0,42,411,9.8,0
Jerico Richardson,Nevada,MWC,10,26,271,10.4,1,0,0,,0,26,271,10.4,1
Emanuel Thompson,Troy,Sun Belt,13,80,820,10.3,6,0,0,,0,80,820,10.3,6
Jaylen Samuels,North Carolina State,ACC,13,55,565,10.3,7,33,189,5.7,6,88,754,8.6,13
Alfonso Onunwor,Idaho,Sun Belt,13,39,403,10.3,1,0,0,,0,39,403,10.3,1
James Butler,Nevada,MWC,12,37,381,10.3,3,260,1336,5.1,12,297,1717,5.8,15
Corey Lacanaria,Ball State,MAC,9,33,341,10.3,2,0,0,,0,33,341,10.3,2
Tony Pollard,Memphis,American,13,29,298,10.3,2,31,159,5.1,1,60,457,7.6,3
Moroni Laulu-Pututau,Brigham Young,Ind,10,27,277,10.3,2,0,0,,0,27,277,10.3,2
Josh Knight,Marshall,CUSA,11,62,631,10.2,5,0,0,,0,62,631,10.2,5
Jamal Morrow,Washington State,Pac-12,13,48,488,10.2,5,90,575,6.4,5,138,1063,7.7,10
Josiah Price,Michigan State,Big Ten,11,38,387,10.2,5,0,0,,0,38,387,10.2,5
Keenen Johnson,Tulsa,American,8,30,305,10.2,1,2,10,5.0,0,32,315,9.8,1
Zach Grant,Illinois,Big Ten,12,26,265,10.2,1,0,0,,0,26,265,10.2,1
Colby Pearson,Brigham Young,Ind,13,38,384,10.1,4,1,3,3.0,0,39,387,9.9,4
Kenny Buyers,North Texas,CUSA,12,32,324,10.1,1,0,0,,0,32,324,10.1,1
Gabe Marks,Washington State,Pac-12,13,89,894,10.0,13,2,6,3.0,0,91,900,9.9,13
Hasaan Henderson,Nevada,MWC,10,30,301,10.0,1,0,0,,0,30,301,10.0,1
Travin Dural,LSU,SEC,9,28,280,10.0,1,1,-2,-2.0,0,29,278,9.6,1
Damon Hazelton Jr,Ball State,MAC,10,51,505,9.9,4,0,0,,0,51,505,9.9,4
Melquise Stovall,California,Pac-12,10,42,415,9.9,3,3,10,3.3,0,45,425,9.4,3
Devin Lauderdale,Texas Tech,Big 12,9,31,307,9.9,2,0,0,,0,31,307,9.9,2
Kareem Hunt,Toledo,MAC,13,41,403,9.8,1,262,1475,5.6,10,303,1878,6.2,11
Alvin Kamara,Tennessee,SEC,11,40,392,9.8,4,103,596,5.8,9,143,988,6.9,13
Cole Herdman,Purdue,Big Ten,12,35,344,9.8,3,0,0,,0,35,344,9.8,3
Mitchell Juergens,Brigham Young,Ind,11,34,333,9.8,2,0,0,,0,34,333,9.8,2
Dylan Collie,Hawaii,MWC,12,33,322,9.8,4,1,9,9.0,0,34,331,9.7,4
KaVontae Turpin,Texas Christian,Big 12,8,30,295,9.8,1,9,84,9.3,0,39,379,9.7,1
Quay Johnson,East Carolina,American,12,58,563,9.7,3,4,9,2.3,0,62,572,9.2,3
Keeon Johnson,Virginia,ACC,12,49,476,9.7,3,0,0,,0,49,476,9.7,3
Dominique Heath,Kansas State,Big 12,13,45,438,9.7,3,2,54,27.0,1,47,492,10.5,4
Connor Cella,Rice,CUSA,12,31,302,9.7,1,0,0,,0,31,302,9.7,1
I'Tavius Mathers,Middle Tennessee State,CUSA,13,66,633,9.6,3,232,1561,6.7,17,298,2194,7.4,20
Ray-Ray McCloud,Clemson,ACC,13,49,472,9.6,2,5,28,5.6,0,54,500,9.3,2
Marcus Green,Louisiana-Monroe,Sun Belt,12,36,344,9.6,4,14,119,8.5,0,50,463,9.3,4
Jovon Durante,West Virginia,Big 12,12,35,331,9.5,2,3,15,5.0,0,38,346,9.1,2
Shakiem Barbel,Kansas,Big 12,11,34,323,9.5,0,0,0,,0,34,323,9.5,0
Bug Rivera,California,Pac-12,11,41,386,9.4,3,2,-4,-2.0,0,43,382,8.9,3
Garrett Dickerson,Northwestern,Big Ten,12,34,318,9.4,5,0,0,,0,34,318,9.4,5
Phillip Lindsay,Colorado,Pac-12,14,53,493,9.3,1,244,1252,5.1,16,297,1745,5.9,17
Eddie Daugherty,Eastern Michigan,MAC,11,31,289,9.3,0,2,12,6.0,0,33,301,9.1,0
Emanuel Byrd,Marshall,CUSA,11,26,242,9.3,3,1,-3,-3.0,0,27,239,8.9,3
Wyatt Houston,Utah State,MWC,12,36,331,9.2,2,0,0,,0,36,331,9.2,2
Desmon White,Texas Christian,Big 12,13,30,276,9.2,1,0,0,,0,30,276,9.2,1
Ervin Phillips,Syracuse,ACC,12,90,822,9.1,6,6,18,3.0,1,96,840,8.8,7
Nate Cole,Cincinnati,American,12,57,518,9.1,4,0,0,,0,57,518,9.1,4
Cameron Posey,Purdue,Big Ten,11,39,356,9.1,3,3,10,3.3,0,42,366,8.7,3
Zach Wright,Rice,CUSA,9,38,346,9.1,1,0,0,,0,38,346,9.1,1
Tee Goree,North Texas,CUSA,8,36,328,9.1,2,0,0,,0,36,328,9.1,2
Ajalen Holley,Louisiana-Monroe,Sun Belt,12,34,310,9.1,1,3,7,2.3,0,37,317,8.6,1
DeAndre Goolsby,Florida,SEC,11,38,342,9.0,3,0,0,,0,38,342,9.0,3
Erich Schneider,Duke,ACC,11,30,269,9.0,3,0,0,,0,30,269,9.0,3
Raekwon James,Kent State,MAC,11,25,225,9.0,0,8,59,7.4,0,33,284,8.6,0
Kyle Hicks,Texas Christian,Big 12,13,47,417,8.9,2,203,1042,5.1,12,250,1459,5.8,14
Johnathan Lloyd,Duke,ACC,11,34,301,8.9,3,1,3,3.0,0,35,304,8.7,3
Mark Walton,Miami (FL),ACC,13,27,240,8.9,1,209,1117,5.3,14,236,1357,5.8,15
Akrum Wadley,Iowa,Big Ten,13,36,315,8.8,3,168,1081,6.4,10,204,1396,6.8,13
Brandon Powell,Florida,SEC,13,45,387,8.6,2,7,6,0.9,0,52,393,7.6,2
Donnel Pumphrey,San Diego State,MWC,14,27,231,8.6,0,349,2133,6.1,17,376,2364,6.3,17
Tyler Watts,Texas State,Sun Belt,12,43,364,8.5,1,3,0,0.0,0,46,364,7.9,1
Matt Dayes,North Carolina State,ACC,13,32,271,8.5,0,249,1166,4.7,10,281,1437,5.1,10
Jeffery Wilson,North Texas,CUSA,11,29,247,8.5,1,169,936,5.5,14,198,1183,6.0,15
Christian McCaffrey,Stanford,Pac-12,11,37,310,8.4,3,253,1603,6.3,13,290,1913,6.6,16
T.J. Logan,North Carolina,ACC,13,29,244,8.4,3,120,650,5.4,7,149,894,6.0,10
Aaron Jones,UTEP,CUSA,12,28,233,8.3,3,229,1773,7.7,17,257,2006,7.8,20
Elijah McGuire,Louisiana,Sun Belt,13,29,238,8.2,2,232,1127,4.9,7,261,1365,5.2,9
Artavis Scott,Clemson,ACC,15,76,614,8.1,5,6,11,1.8,0,82,625,7.6,5
Jarred Craft,Louisiana Tech,CUSA,14,42,340,8.1,4,191,1074,5.6,9,233,1414,6.1,13
Marlon Mack,South Florida,American,12,28,227,8.1,0,174,1187,6.8,15,202,1414,7.0,15
OJ Clark,New Mexico State,Sun Belt,11,43,338,7.9,1,0,0,,0,43,338,7.9,1
D'Eriq King,Houston,American,9,29,228,7.9,1,15,56,3.7,0,44,284,6.5,1
Taquan Mizzell,Virginia,ACC,12,52,404,7.8,2,187,940,5.0,5,239,1344,5.6,7
Stedman Mayberry,Texas State,Sun Belt,12,41,321,7.8,0,157,593,3.8,5,198,914,4.6,5
Ryan Davis,Auburn,SEC,10,25,194,7.8,1,3,5,1.7,0,28,199,7.1,1
Jordan Chunn,Troy,Sun Belt,13,30,228,7.6,0,279,1288,4.6,16,309,1516,4.9,16
Larry Rose III,New Mexico State,Sun Belt,9,25,180,7.2,0,159,865,5.4,4,184,1045,5.7,4
James Williams,Washington State,Pac-12,13,48,342,7.1,1,102,585,5.7,6,150,927,6.2,7
Anthony Scott,East Carolina,American,8,23,164,7.1,3,79,384,4.9,2,102,548,5.4,5
Isaiah Johnson-Mack,Washington State,Pac-12,11,35,246,7.0,1,0,0,,0,35,246,7.0,1
Willy Ivery,North Texas,CUSA,11,25,173,6.9,2,90,489,5.4,6,115,662,5.8,8
Markell Jones,Purdue,Big Ten,11,32,215,6.7,0,153,616,4.0,4,185,831,4.5,4
Devon Spalding,Central Michigan,MAC,11,31,204,6.6,1,138,758,5.5,6,169,962,5.7,7
Duke Catalon,Houston,American,9,44,281,6.4,3,145,528,3.6,4,189,809,4.3,7
Alex Gardner,Florida International,CUSA,12,30,191,6.4,0,181,930,5.1,6,211,1121,5.3,6
Justin Jackson,Northwestern,Big Ten,13,35,219,6.3,0,298,1524,5.1,15,333,1743,5.2,15
Gerard Wicks,Washington State,Pac-12,13,29,184,6.3,1,88,475,5.4,11,117,659,5.6,12
Devin Singletary,Florida Atlantic,CUSA,12,26,163,6.3,0,152,1021,6.7,12,178,1184,6.7,12
Royce Freeman,Oregon,Pac-12,11,23,144,6.3,1,168,945,5.6,9,191,1089,5.7,10
Tion Green,Cincinnati,American,12,29,167,5.8,0,159,743,4.7,2,188,910,4.8,2
Marquis Young,Massachusetts,Ind,12,26,147,5.7,0,197,898,4.6,4,223,1045,4.7,4
Elijah Hood,North Carolina,ACC,11,25,142,5.7,0,145,858,5.9,8,170,1000,5.9,8
Devine Redding,Indiana,Big Ten,13,27,146,5.4,2,253,1122,4.4,7,280,1268,4.5,9
Darian Green,Ball State,MAC,8,24,124,5.2,0,57,311,5.5,1,81,435,5.4,1
